WWWWWWTTTTWWWWWW
WBBBBVBBBBBBBBBW
WBBBBBBBBBBBBBBO
WBBBBBBBBBBBBBBO
WBBBBBBBBBBBBBBW
WBBBBBBBBBBBBBBW
WBBBBBBBBBBBBBWW
WBBBBBBBBBBBBBBW
WBBBBBBBBBBBBBBW
WWWWWWWWWWWWWWWW