WWWWWWTTTTWWWWWW
WWWWWWBBBBWWWWWW
WWWWWWBBBBWWWWWW
WWWBBBBBBBVBBWWW
WWWBBBBBBBBBBWWW
WWWBBBBBBBBBBWWW
WWWBBBBBBBBBBWWW
WWWWWWBBBBWWWWWW
WWWWWWBBBBWWWWWW
WWWWWWOOOOWWWWWW
